You wake up on a metal table in the center of a chrome room. You have no memory of how you got here, but suspect that The Organization has finally captured you. It looks like they must have been preparing to run new experiments on you! You must escape before The Organization can use you as a test subject again.

Laboratory Escape
An Interactive Fiction by Cole Damon
Release 1 / Serial number 141006 / Inform 7 build 6L38 (I6/v6.33 lib 6/12N) SD

Operating Room
After taking a look around the room you are in, you can see many surgical tools around. The bright lights shine off the metal walls and floor, and illuminates everything. There is a door to the south, that must be the way out.

>x surgical tools
You can't see any such thing.

>x light
You can't see any such thing.

>x floor
You can't see any such thing.

>s
(first opening Operating door)

Biometric Data Storage
This room is covered with computer screens with different images and numbers on them. It also has a sign has a sign calling it Biometric Data Storage. These computers must have been monitoring your condition. There is a door to the east, but it seems to be locked, you will have to find a way to unlock it. Maybe there could be a clue in the computers.

You can see Genetics door and Biometric computers here.

>x sign
A bright electric sign declaring what room you are in.

>x computers
Biometric computers is currently switched off.

>turn on computers
You switch Biometric computers on.

>l computers
 Test subject W-61 has been successfully captured and sedated. Subject's vitals are at nominal levels and is sedated. Augmentation process is prepared and only awaits arrival of Organization doctors. Blood pressure: 1.0, nominal. Heart beat: 100 bpm, nominal. Height: 1.72 meters. Birth: 9-19-98. Age: 16 years 5 months 23 days and counting.

Biometric computers is currently switched on.

>x me
As good-looking as ever.

>e
(first opening Genetics door)
The door is sealed shut and seems like opens only when the correct combination is spun in the spin dial. You must spin the dial to the correct 5 digit code.

>x door
(Genetics door)
Its a sealed metal door. This is the only other door in the room, so the only way out, but it seems to to be locked with many mechanical arms. The only opening is a mechanical spin dial that looks like it requires a 5 digit code to be spun to unlock. Just like The Organization to Perhaps the computers holds a clue.

>spin 9
You can't see any such thing.

>91998
That's not a verb I recognise.

>spin 91998
You can't see any such thing.

>spin dial to 91998
(Genetics door to that)
The door unlocks and opens with a hiss

>open door
(Genetics door)
You open Genetics door.

>enter door
(Genetics door)

Genetic Testing
This new room seems very different from the last. This room is filled with test tubes filled with different colored liquids. There also seems to be a lack of computers compared to the last room, instead there are a lot of sticky notes. This makes sense for it shows the, diversity, of how Organization scientists work. There still seems to be no way to escape besides another sealed door to the south.

You can see Genetics door, Cybernetics door and sticky notes here.

>x liquids
You can't see any such thing.

>x computers
You can't see any such thing.

>x notes
Varient lifeform DNA strands have been analyzed and selected. After much initial experimentation trials, the Xeno Variable Organism compound has finaly completed and is read for human experimentation. Test subject W-61 has recently been recaptured and chosen as the first live human experment with the XVO compound. This is the next step in operation World Organization. (a funny side note, in roman numerals, XVO makes my favoret time of day, 1050, or rather 10:50 in the morning. lol)

>s
(first opening Cybernetics door)
The door is sealed shut and seems like opens only when the correct combination is spun in the spin dial. You must spin the dial to the correct .

>x door
Which do you mean, Genetics door or Cybernetics door?

>x cybernetics door
Its another door. This one is like the one you just came through, big and locked with many different parts of machinery to keep it in place, but this time it looks like the code is 4 digits long. Its still the only way out though, so you need to hurry and find a way to open it, agents of The Organization will no doubt be here soon! No way do you want to be a lab rat agian.

>spin to 1050
You can't see any such thing.

>spin dial to 1050
Which do you mean, Genetics door or Cybernetics door?

>spin cybernetics door dial to 1050
The door unlocks and slowly jerks opens with the clang of moving parts.

>open cybernetics door
You open Cybernetics door.

>enter cybernetics door
Cybernetics Lab
This room seems to be a laboratory filled with robotic equipment. Considering that some of the machines look like robotic versions of human body parts, like glowing metal eyes and arms with talons for fingers, you can only assume The Organization was also planing to implant cybernetic body parts in you! Now not only is your genetic makeup on the line, but your biological body as well!

You can see Cybernetics door, Hall door and Cybernetic computers here.

>x computers
Cybernetic computers is currently switched off.

>turn on computer
You can't see any such thing.

>turn on cybernetics computers
You switch Cybernetic computers on.

>x computers
 Test subject W-61 displays high affinity for cybernetic implants. Organization top scientists have allowed that if experiments with XVO compound result in failure, but subject body is still alive and usable, that W-61 is allowed to be the testing bed for project Organized Roboticly Bonded Solders. The affinity of W-61 for cybernetics is high enough to show a 000 rejection rate, a perfect test subject for project ORBS

Cybernetic computers is currently switched on.

>x hall door
Another mechanical door, really? You would think that The Organization would at least start to make it a challenge to escape, but all the better for you. It looks like this door needs a 3 digit code to be spun.

>spin hall door to 000
*** Run-time problem P10: Since Security door is not allowed the property "locked", it is against the rules to try to use it.

The door unlocks and opens with a hiss

I beg your pardon?

>x me
As good-looking as ever.

* * *

>open the door
You open Operating door.

>walk through the door
Biometric Data Storage
This room is covered with computer screens with different images and numbers on them. It also has a sign has a sign calling it Biometric Data Storage. These computers must have been monitoring your condition. There is a door to the east, but it seems to be locked, with a spin dial lock that requires a 5 digit code to be spun all at once. You will have to find a way to unlock it. Maybe there could be a clue in the computers.

You can see Genetics door and Biometric computers here.

>go to biometric computers
You can't see any such thing.

>walk to computers
You can't see any such thing.

>examine computer
You can't see any such thing.

>examine door
(Genetics door)
Its a sealed metal door. This is the only other door in the room, so the only way out, but it seems to to be locked with many mechanical arms. The only opening is a mechanical dial that looks like it is required to spin to a 5 digit code all at once in order to be unlocked. Just like The Organization to use heavy security in their labs. Perhaps the computers holds a clue.

>read computer
You can't see any such thing.

>turn on computer
You can't see any such thing.

>unlock door
What do you want to unlock Genetics door with?

>key
I didn't understand that sentence.

>unlock door with key
You can't see any such thing.

>open genetics door
The door is sealed shut and seems like opens only when the correct combination is spun in the spin dial at once. You must spin the dial to the correct 5 digit code.

>spin the dial
I didn't understand that sentence.

>spin the dial lock
I didn't understand that sentence.

>go to computers
You can't see any such thing.

>examine the computers
Biometric computers is currently switched off.

>switch on computer
You can't see any such thing.

>switch on the biometric computers
You switch Biometric computers on.

>read computers
 Test subject W-61 has been successfully captured and sedated. Subject's vitals are at nominal levels and is sedated. Augmentation process is prepared and only awaits arrival of Organization doctors. Blood pressure: 1.0, nominal. Heart beat: 100 bpm, nominal. Height: 1.72 meters. Birth: 9-19-98. Age: 16 years 5 months 23 days and counting.

Biometric computers is currently switched on.

>open genetics door
The door is sealed shut and seems like opens only when the correct combination is spun in the spin dial at once. You must spin the dial to the correct 5 digit code.

>9-19-97
That's not a verb I recognise.

>9-19-98
That's not a verb I recognise.

>unlock dial
What do you want to unlock Genetics door with?

>9-19-98
I didn't understand that sentence.

>unlock dial
What do you want to unlock Genetics door with?

>unlock with 91998
You can't see any such thing.

>unlock dial
What do you want to unlock Genetics door with?

>91998
I didn't understand that sentence.

>spin dial 91998
I didn't understand that sentence.

>Spin the dial to 91998
(Genetics door to that)
The door unlocks and opens with a hiss

>walk through door
(Genetics door)
(first opening Genetics door)

Genetic Testing
This new room seems very different from the last. This room is filled with test tubes filled with different colored liquids. There also seems to be a lack of computers compared to the last room, instead there are a lot of sticky notes. This makes sense for it shows the, diversity, of how Organization scientists work. There still seems to be no way to escape besides another sealed door to the south.

You can see Genetics door, Cybernetics door and sticky notes here.

>open cybernetic door
The door is sealed shut and seems like opens only when the correct combination is spun in the spin dial. You must spin the dial to the correct .

>read sticky notes
Varient lifeform DNA strands have been analyzed and selected. After much initial experimentation trials, the Xeno Variable Organism compound has finaly completed and is read for human experimentation. Test subject W-61 has recently been recaptured and chosen as the first live human experment with the XVO compound. This is the next step in operation World Organization. (a funny side note, in roman numerals, XVO makes my favoret time of day, a 1, a 5, and then O makes 0, or rather 1:50 in the morning. lol)

>open cybernetics door
The door is sealed shut and seems like opens only when the correct combination is spun in the spin dial. You must spin the dial to the correct .

>spin the dial to XVO
Which do you mean, Genetics door or Cybernetics door?

>cybernetics door
I didn't understand that number.

>Open cybernetics door
The door is sealed shut and seems like opens only when the correct combination is spun in the spin dial. You must spin the dial to the correct .

>spin the cybernetics door dial to 150150
Click, and not much else happens.

>examine the cybernetics door
Its another door. This one is like the one you just came through, big and locked with many different parts of machinery to keep it in place, but this time it looks like the code is 4 digits long. Its still the only way out though, so you need to hurry and find a way to open it, agents of The Organization will no doubt be here soon! No way do you want to be a lab rat agian.

>open cybernetics door
The door is sealed shut and seems like opens only when the correct combination is spun in the spin dial. You must spin the dial to the correct .

>spin the dial to 150
Which do you mean, Genetics door or Cybernetics door?

>cybernetics door
The door unlocks and slowly jerks opens with the clang of moving parts.

>walk through cybernetics door
(first opening Cybernetics door)

Cybernetics Lab
This room seems to be a laboratory filled with robotic equipment. Considering that some of the machines look like robotic versions of human body parts, like glowing metal eyes and arms with talons for fingers, you can only assume The Organization was also planing to implant cybernetic body parts in you! Now not only is your genetic makeup on the line, but your biological body as well! The next door is to the west.

You can see Cybernetics door, Hall door and Cybernetic computers here.

>open hall door
The door is sealed shut and seems like it will only opens only when the correct combination is spun in the spin dial. You must spin the dial to the correct

>examind robotic equipment
That's not a verb I recognise.

>examine robotic equipment
You can't see any such thing.

>examine machines
You can't see any such thing.

>examine body parts
You can't see any such thing.

>examine hall door
Another mechanical door, really? You would think that The Organization would at least start to make it a challenge to escape, but all the better for you. It looks like this door needs a 3 digit code to be spun.

>examine robotic equipment
You can't see any such thing.

>examine talons
You can't see any such thing.

>examine laboratory
You can't see any such thing.

>examine body parts
You can't see any such thing.

>examine cybernetics computers
Cybernetic computers is currently switched off.

>switch on cybernetics computers
You switch Cybernetic computers on.

>examine cybernetic computers
 Test subject W-61 displays high affinity for cybernetic implants. Organization top scientists have allowed that if experiments with XVO compound result in failure, but subject body is still alive and usable, that W-61 is allowed to be the testing bed for project Organized Roboticly Bonded Solders. The affinity of W-61 for cybernetics is high enough to show a 000 rejection rate, a perfect test subject for project ORBS

Cybernetic computers is currently switched on.

>unlock hall door
What do you want to unlock Hall door with?

>unlock hall door with 000
You can't see any such thing.

>open hall door
The door is sealed shut and seems like it will only opens only when the correct combination is spun in the spin dial. You must spin the dial to the correct

>spin the dial to 000
Which do you mean, Cybernetics door or Hall door?

>hall door
The door unlocks and opens with a hiss

>walk through the hall door
(first opening Hall door)

Security Hallway
A long hallway going south, like the kind in movies where all the traps are, but there only seems to be a camera. Oh no, that means The Organization now knows your trying to escape. You can see the exit at the other end, get out as fast as you can, or you most surly will never get a chance to escape again! Maybe making sure the camera can't see you can buy some time.

You can see Hall door, Final door and camera here.

>buy time
You can't see any such thing.

>examine camera
 A security camera that is watching your every move. The perfect image for The Organization. .

>go through final door
(first opening Final door)
There is nothing to open the door with, something different must be done to unlock the door. You especially can not escape with that camera showing The Organization what you are doing.

>examine final door
This door is smooth and has nothing you can interact with, there must be something else you have to do to unlocks the door.

>unlock the final door
What do you want to unlock Final door with?

>push open the final door
You can't see any such thing.

>examine cameras
You can't see any such thing.

>examine camera
 A security camera that is watching your every move. The perfect image for The Organization. .

>go to camera
You can't see any such thing.

>walk to camera
You can't see any such thing.

>break camera
Violence isn't the answer to this one.

>dance in front of the camera
That's not a verb I recognise.

>turn camera
It is fixed in place.

>unplug camera
That's not a verb I recognise.

>tunr off camera
That's not a verb I recognise.

>turn off camera
It isn't something you can switch.

>check inventory
You can't see any such thing.

>inventory
You are carrying nothing.

>unlock final door
What do you want to unlock Final door with?

>unlock final door with body part
You can't see any such thing.

>walk through hall door
Cybernetics Lab
This room seems to be a laboratory filled with robotic equipment. Considering that some of the machines look like robotic versions of human body parts, like glowing metal eyes and arms with talons for fingers, you can only assume The Organization was also planing to implant cybernetic body parts in you! Now not only is your genetic makeup on the line, but your biological body as well! The next door is to the west.

You can see Hall door, Cybernetics door and Cybernetic computers here.

>take cybernetic computers
Taken.

>take body parts
You can't see any such thing.

>take robotic equipment
You can't see any such thing.

>take talons
You can't see any such thing.

>take cybernetic body parts
You can't see any such thing.

>walk through cybernetics door
Genetic Testing
This new room seems very different from the last. This room is filled with test tubes filled with different colored liquids. There also seems to be a lack of computers compared to the last room, instead there are a lot of sticky notes. This makes sense for it shows the, diversity, of how Organization scientists work. There still seems to be no way to escape besides another sealed door to the south.

You can see Cybernetics door, Genetics door and sticky notes here.

>take test tubes
You can't see any such thing.

>take computers
You already have that.

>take sticky notes
Taken.

>walk through hall door
You can't see any such thing.

>walk through cybernetics door
Cybernetics Lab
This room seems to be a laboratory filled with robotic equipment. Considering that some of the machines look like robotic versions of human body parts, like glowing metal eyes and arms with talons for fingers, you can only assume The Organization was also planing to implant cybernetic body parts in you! Now not only is your genetic makeup on the line, but your biological body as well! The next door is to the west.

You can see Cybernetics door and Hall door here.

>walk through hall door
Security Hallway
A long hallway going south, like the kind in movies where all the traps are, but there only seems to be a camera. Oh no, that means The Organization now knows your trying to escape. You can see the exit at the other end, get out as fast as you can, or you most surly will never get a chance to escape again! Maybe making sure the camera can't see you can buy some time.

You can see Hall door, Final door and camera here.

>walk through final door
(first opening Final door)
There is nothing to open the door with, something different must be done to unlock the door. You especially can not escape with that camera showing The Organization what you are doing.

>cover camera
It isn't something you can close.

>go to camera
You can't see any such thing.

>inventory
You are carrying:
  sticky notes
  Cybernetic computers

>sticky notes
That's not a verb I recognise.

>cover camera with sticky notes
I only understood you as far as wanting to cover camera.

>use sticky notes to block camera
That's not a verb I recognise.

>unlock final door
What do you want to unlock Final door with?

>sticky notes
That doesn't seem to fit the lock.

>buy time
You can't see any such thing.

>put something on the camera
You can't see any such thing.

>put sticky notes on camera
The lense of the camera is now covered.

>unlock final door
(with Cybernetic computers)
That's unlocked at the moment.

>walk through final door
(first opening Final door)

Outside room
You can see Final door here.

    *** The door silently glides open to the outside world. Freedom now awaits. You can now be free from becoming an Organization experiment once again. They might have created you, but they can never control you! ***

Would you like to RESTART, RESTORE a saved game, QUIT or UNDO the last command?

* * *

>s
(first opening Operating door)

Biometric Data Storage
This room is covered with computer screens with different images and numbers on them. It also has a sign has a sign calling it Biometric Data Storage. These computers must have been monitoring your condition. There is a door to the east, but it seems to be locked, with a spin dial lock that requires a 5 digit code to be spun all at once. You will have to find a way to unlock it. Maybe there could be a clue in the computers.

You can see Genetics door and Biometric computer here.

>spin dial to 91998
(Genetics door to that)
The door unlocks and opens with a hiss

>e
(first opening Genetics door)

Genetic Testing
This new room seems very different from the last. This room is filled with test tubes filled with different colored liquids. There also seems to be a lack of computers compared to the last room, instead there are a lot of sticky notes. This makes sense for it shows the, diversity, of how Organization scientists work. There still seems to be no way to escape besides another sealed door to the south.

You can see Genetics door, Cybernetics door and sticky notes here.

>spin cybernetics door to 1050
The door unlocks and opens with a hiss

>s
(first opening Cybernetics door)

Cybernetics Lab
This room seems to be a laboratory filled with robotic equipment. Considering that some of the machines look like robotic versions of human body parts, like glowing metal eyes and arms with talons for fingers, you can only assume The Organization was also planing to implant cybernetic body parts in you!

You can see Cybernetics door and Hall door here.

>spin dial to 1
Which do you mean, Cybernetics door or Hall door?

>hall
*** Run-time problem P10: Since Security door is not allowed the property "locked", it is against the rules to try to use it.

The door unlocks and opens with a hiss

* * *

>e
(first opening Genetics door)

Genetic Testing
This new room seems very different from the last. This room is filled with test tubes filled with different colored liquids. There also seems to be a lack of computers compared to the last room, instead there are a lot of sticky notes. This makes sense for it shows the, diversity, of how Organization scientists work. There still seems to be no way to escape besides another sealed door to the south.

You can see Genetics door, Cybernetics door and sticky notes here.

>take notes
Taken.

>spin dial to 1050
Which do you mean, Genetics door or Cybernetics door?

>cybernetics door
Cybernetics door does not spin.

>spain cybernetics door dial to 1050
That's not a verb I recognise.

>spin cybernetics door dial to 1050
Cybernetics door does not spin.

* * *

>take notes
Taken.

>spin dial to 150
Which do you mean, Genetics door or Cybernetics door?

>cybernetics
The door unlocks and slowly jerks opens with the clang of moving parts.

>s
(first opening Cybernetics door)

Cybernetics Lab
This room seems to be a laboratory filled with robotic equipment. Considering that some of the machines look like robotic versions of human body parts, like glowing metal eyes and arms with talons for fingers, you can only assume The Organization was also planing to implant cybernetic body parts in you! Now not only is your genetic makeup on the line, but your biological body as well! The next door is to the west.

You can see Cybernetics door, Hall door and Cybernetic computer here.

>spin dial to 000
Which do you mean, Cybernetics door or Hall door?

>hall
The door unlocks and opens with a hiss

>w
(first opening Hall door)

Security Hallway
A long hallway, like the kind in movies where all the traps are, but there only seems to be a camera. Oh no, that meens The Organization now knows your trying to escape. You can see the exit at the other end, get out as fast as you can, or you most surly will never get a chance to escape again! Maybe making sure the camera can't see you can buy some time.

You can see Hall door, Final door and camera here.

>put notes on camera
The lense of the camera is now covered.

>s
(first opening Final door)

Final room
You can see Final door here.

    *** The door silently glides open to the outside world. Freedom now awaits. You can now be free from becoming an Organization experiment once again. They might have created you, but they can never control you! ***

Would you like to RESTART, RESTORE a saved game, QUIT or UNDO the last command?

* * *

>hall
The door unlocks and opens with a hiss

>e
You can't go that way.

>w
(first opening Hall door)

Security Hallway
A long hallway going south, like the kind in movies where all the traps are, but there only seems to be a camera. Oh no, that means The Organization now knows your trying to escape. You can see the exit at the other end, get out as fast as you can, or you most surely will never get a chance to escape again! Maybe making sure the camera can't see you can buy some time.

You can see Hall door, Final door and camera here.

>cover camera with notes
(first taking camera)
That's fixed in place.

>open hall door
That's already open.

>s
(first opening Final door)
There is nothing to open the door with, something different must be done to unlock the door. You especially can not escape with that camera showing The Organization what you are doing.

* * *

>e
(first opening Genetics door)

Genetic Testing
This new room seems very different from the last. This room is filled with test tubes filled with different colored liquids. There also seems to be a lack of computers compared to the last room, instead there are a lot of sticky notes. This makes sense for it shows the, diversity, of how Organization scientists work. There still seems to be no way to escape besides another sealed door to the south.

You can see Genetics door, Cybernetics door and sticky notes here.

>spin dial to 1050
Which do you mean, Genetics door or Cybernetics door?

>cybernetics
The door unlocks and opens with a hiss

>s
(first opening Cybernetics door)

Cybernetics Lab
This room seems to be a laboratory filled with robotic equipment. Considering that some of the machines look like robotic versions of human body parts, like glowing metal eyes and arms with talons for fingers, you can only assume The Organization was also planing to implant cybernetic body parts in you!

You can see Cybernetics door and Hall door here.

* * *

>e
(first opening Genetics door)

Genetic Testing
This new room seems very different from the last. This room is filled with test tubes filled with different colored liquids. There also seems to be a lack of computers compared to the last room, instead there are a lot of sticky notes. This makes sense for it shows the, diversity, of how Organization scientists work. There still seems to be no way to escape besides another sealed door to the south.

You can see Genetics door, Cybernetics door and sticky notes here.

>open door
(Genetics door)
The door is sealed shut and seems like opens only when the correct combination is spun in the spin dial. You must spin the dial to the correct 5 digit code.

>spin dial to 91998
(Genetics door to that)
Genetics door does not spin.

>spin getentics door to 91998
You can't see any such thing.

* * *

>s
(first opening Operating door)

Biometric Data Storage
This room is covered with computer screens with different images and numbers on them. It also has a sign has a sign calling it Biometric Data Storage. These computers must have been monitoring your condition. There is a door to the east, but it seems to be locked, with a spin dial lock that requires a 5 digit code to be spun all at once. You will have to find a way to unlock it. Maybe there could be a clue in the computers.

You can see Genetics door and Biometric computer here.

>turn on computers
You switch Biometric computers on.

>x computers
 Test subject W-61 has been successfully captured and sedated. Subject's vitals are at nominal levels and is sedated. Augmentation process is prepared and only awaits arrival of Organization doctors. Blood pressure: 1.0, nominal. Heart beat: 100 bpm, nominal. Height: 1.72 meters. Birth: 9-19-98. Age: 16 years 5 months 23 days and counting.

Biometric computers is currently switched on.

>x door
(Genetics door)
Its a sealed metal door. This is the only other door in the room, so the only way out, but it seems to to be locked with many mechanical arms. The only opening is a mechanical spin dial that looks like it requires a 5 digit code to be spun to unlock. Just like The Organization to Perhaps the computers holds a clue.

>turn dial to 91998
You can't see any such thing.

* * *

>s
(first opening Operating door)

Biometric Data Storage
This room is covered with computer screens with different images and numbers on them. It also has a sign has a sign calling it Biometric Data Storage. These computers must have been monitoring your condition. There is a door to the east, but it seems to be locked, with a spin dial lock that requires a 5 digit code to be spun all at once. You will have to find a way to unlock it. Maybe there could be a clue in the computers.

You can see Genetics door and Biometric computer here.

>spin computers
I didn't understand that sentence.

>spin dials
I didn't understand that sentence.

>spin dial
I didn't understand that sentence.

* * *

>s
(first opening Operating door)

Biometric Data Storage
This room is covered with computer screens with different images and numbers on them. It also has a sign has a sign calling it Biometric Data Storage. These computers must have been monitoring your condition. There is a door to the east, but it seems to be locked, with a spin dial lock that requires a 5 digit code to be spun all at once. You will have to find a way to unlock it. Maybe there could be a clue in the computers.

You can see Genetics door and Biometric computer here.

>open door
(Genetics door)
The door is sealed shut and seems like opens only when the correct combination is typed in the keypad. You must type the correct 5 digit code.

>x door
(Genetics door)
Its a sealed metal door. This is the only other door in the room, so the only way out, but it seems to to be locked wtih many machanical arms. The only opening is a machanical keypad that looks like it is requiered to have a 5 digit code typed into it. Perhaps the computers holds a clue.

>type 91998
You can't see any such thing.

>type in keypad 91998
I didn't understand that sentence.

>type 91998 in keypad
You can't use multiple objects with that verb.

>type 91998 in door
You can't use multiple objects with that verb.

>type door to 91998
(Genetics door to that)
The door unlocks and opens with a hiss

* * *

>s
(first opening Operating door)

Biometric Data Storage
This room is covered with computer screens with different images and numbers on them. It also has a sign has a sign calling it Biometric Data Storage. These computers must have been monitoring your condition. There is a door to the east, but it seems to be locked, with a spin dial lock that requires a 5 digit code to be spun all at once. You will have to find a way to unlock it. Maybe there could be a clue in the computers.

You can see Genetics door and Biometric computer here.

>x computers
Biometric computers is currently switched off.

* * *

>turn on computers
You switch Biometric computers on.

>x computers
 Test subject w-61 has been successfully captured and sedated. Subject's vitals are at nominal levels and is sedated. Augmentation process is prepared and only awaits arrival of Organization doctors. Blood pressure: 1.0, nominal. Heart beat: 100 bpm, nominal. Height: 1.72 meters. Birth: 9-19-98. Age: 16 years 5 months 23 days and counting.

Biometric computers is currently switched on.

* * *

>s
(first opening Operating door)

Biometric Data Storage
This room is covered with computer screens with different images and numbers on them. It also has a sign has a sign calling it Biometric Data Storage. These computers must have been monitoring your condition. There is a door to the east, but it seems to be locked, with a spin dial lock that requires a 5 digit code to be spun all at once. You will have to find a way to unlock it. Maybe there could be a clue in the computers.

You can see Genetics door and Biometric computer here.

>spin dial
I didn't understand that sentence.

* * *

>s
(first opening Operating door)

Biometric Data Storage
This room is covered with computer screens with different images and numbers on them. It also has a sign has a sign calling it Biometric Data Storage. These computers must have been monitoring your condition. There is a door to the east, but it seems to be locked, with a spin dial lock that requires a 5 digit code to be spun all at once. You will have to find a way to unlock it. Maybe there could be a clue in the computers.

You can see Genetics door and Biometric computer here.

>turn dial to 91998
You can't see any such thing.

>turn genetics door to 91998
I only understood you as far as wanting to turn Genetics door.

* * *

>turn dial to 91998
You can't see any such thing.

>turn dial to 91998
You can't see any such thing.

>turn door to 91998
You can't see any such thing.

* * *

>turn dial to 91998
You can't see any such thing.

>spin dial to 91998
(Genetics door to that)
The door unlocks and opens with a hiss

* * *

>x tools
Advanced looking tools with many sharp pointy ends. The Organization always did have a flair for dramatic tools.

>take tools
Those look dangerous, you might hurt your self

>x lights
You can't see any such thing.

>s
(first opening Operating door)

Biometric Data Storage
This room is covered with computer screens with different images and numbers on them. It also has a sign has a sign calling it Biometric Data Storage. These computers must have been monitoring your condition. There is a door to the east, but it seems to be locked, you will have to find a way to unlock it. Maybe there could be a clue in the computers.

You can see Genetics door and Biometric computers here.