You wake up on a metal table in the center of a chrome room. You have no memory of how you got here, but suspect that The Organization has finaly captured you. It looks like they must have been preparing to run new experiments on you! You mest escape before The Organization can use you as a test subject again.

labratory
An Interactive Fiction by Cole Damon
Release 1 / Serial number 141001 / Inform 7 build 6L38 (I6/v6.33 lib 6/12N) SD

Operating Room
After taking a look around the room you are in, you can see many surgical tools around. The bright lights shine off the metal walls and floor, and illuminates everything. There is a door to the south, that must be the way out.

You can see tools here.

>x door
You see nothing special about Operating door.

>s
(first opening Operating door)

Biometric Data Storage
This room has a sign calling it Biometric Data Storage, these computers must have been monatoring your condition. There is a door to the east, but it seems to be locked, you will have to find a way to unlock it. Maybe there could be a clue in the computers.

You can see Genetics door and Biometric computers here.

>x door
(Genetics door)
You see nothing special about Genetics door.

>x computers
Biometric computers is currently switched off.

>turn computers on
You switch Biometric computers on.

>use computers
That's not a verb I recognise.

>x computers
Biometric computers is currently switched on.

* * *

>take tools
You can't see any such thing.

* * *

>take all
(tools)
Those look dangerous, you might hurt your self

>i
You are carrying nothing.

* * *

>l
Operating Room

* * *

>x tools
Advanced looking tools with many shap pointy ends.

>take tools
Those look dangerous, you might hurt your self

* * *

>e
You can't go that way.

>w
You can't go that way.

>s
Biometric Data Storage

>e
Genetic Testing

>s
Cybernetics Lab

>w
Security Hallway

* * *

>s
(first opening Operating door)

Biometric Data Storage
This room has a sign calling it Biometric Data Storage, these computers must have been monatoring your condition. There is a door to the east, but it seems to be locked, you will have to find a way to unlock it. Maybe there could be a clue in the computers.

You can see Genetics door and Biometric computers here.

>spin computers
I didn't understand that sentence.

* * *

>s
(first opening Operating door)

Biometric Data Storage
This room has a sign calling it Biometric Data Storage, these computers must have been monatoring your condition. There is a door to the east, but it seems to be locked, you will have to find a way to unlock it. Maybe there could be a clue in the computers.

You can see Genetics door and Biometric computers here.

>x computers
Biometric computers is currently switched off.

* * *

>turn on computers
You switch Biometric computers on.

>x computers
Biometric computers is currently switched on.

* * *

>s
(first opening Operating door)

Biometric Data Storage
This room has a sign calling it Biometric Data Storage, these computers must have been monatoring your condition. There is a door to the east, but it seems to be locked, you will have to find a way to unlock it. Maybe there could be a clue in the computers.

You can see Genetics door and Biometric computers here.

>e
(first opening Genetics door)

Genetic Testing
You can see Genetics door and Cybernetics door here.

>x genetics door
You see nothing special about Genetics door.

>x cybernetics door
You see nothing special about Cybernetics door.

>s
(first opening Cybernetics door)

Cybernetics Lab
This room seems to be a labratory filled with robotic equipment. Considering that some of the machines look like robotic versons of human body parts, like glowing metal eyes and arms with talons for fingers, you can only assume The Organization was also planing to implant cybernetic body parts in you!

You can see Cybernetics door and Security door here.

* * *

>s
(first opening Operating door)

Biometric Data Storage
This room has a sign calling it Biometric Data Storage, these computers must have been monatoring your condition. There is a door to the east, but it seems to be locked, you will have to find a way to unlock it. Maybe there could be a clue in the computers.

You can see Genetics door and Biometric computers here.

>open door
(Genetics door)
The door is sealed shut and seems like opens only when the correct combination is typed in the keypad. You must type the correct 5 digit code.

>spin 91998
You can't see any such thing.

>spin 91990 in door
You can't use multiple objects with that verb.

>spin dial to 91998
(Genetics door to that)
The door unlocks and opens with a hiss